111111111111111111111111111111111111111111111111111
1E0000000000000000000000000000000000000000000000001
10000000000000P000000000000000000000000000000000001
10000000000000000000000000000000000000C000000000001
100000000000000000000000000000000000000000000000001
10000CCCCCCCCCCCCCCCCCCCCCCCCCCCCCCCCCCCCCCCC000001
100000111100000111110001111100011111100000000000001
100000100100000000010000000100010C00100000000000001
10000000010000CCCCC10000000100000C00100000000000001
100000000100000111110001111100000C00100000000000001
100000000100000CCCC10000000100000C00100000000000001
10000000010000000001000CCC0100000C00100000000000001
100000000100000000010000000100000C00100000000000001
100000011111000111110001111100000C00100000000000001
100000000000000000CCCCCCCCCCCCCCCC00000000000000001
100001111110010000000000000000000000100000000000001
100001000010010000000000000000000000000000000000001
100001000010011111001111100111111000100000000000001
100001000010010001001000100000001000100000000000001
100001000010010001001111100111111000100000000000001
100001000010010001001000000100001000100000000000001
100001111110011111001111100111111000100000000000001
100000000000000000000000000000000000100000000000001
1000000000CCCCCCCCCCCCC0000000010000100000000000001
100000000000000000000000000000011111100000000000001
100000000000000000000000000000000000000000000000001
100000000CCCCCCCCCCCCCCCCCCCCCCCCCCCCCC000000000001
111111111111111111111111111111111111111111111111111