11111111111111111111111
1EC0C0CC00000CEE0000011
1PC0C00000CC00000000001
11111111111111111111111