111111111111111111111111111111111111111111
1E0000000000000C00000C000000000000C0000E01
10100101001000001010010000000101010C0C0C01
10100100101010100010010000000101000000C001
100000000C00C0000000000000000000C11100C001
1C0000000C00C0000000000000000000C11100C001
1C0000000C00C0000C000C0000000000C11100C001
1C000P000C00C0000CC00C0000000000C11100C001
1C0000000C00C0000C00CC0000000000C11100C001
111111111111111111111111111111111111111111