1111111111111111111
10000C0C0C0C0000001
10000C0C0C0C0000001
10000C0C0C0C0000001
10000C0C0C0C0000001
10000C0C0P0C0000011
10000C0C0C0C0000001
10000C0C0C0C00000E1
1E0010C000000000001
1000111000000000001
1000000000000000001
1000000000000000001
100C000000000000001
1111111111111111111